-- acronym_list
1-9
3des - triple data encryption standard
A
aaa - authentication, authorization, accounting
ace - access control entry
acl - access control list
aes - advanced encryption standard
ajax - asynchronous javascript and xml
ansi - american national standards institute
api - application programming interface
ascii - american standard code for information interchange
B
bau - business as usual
bp - bundle patch
C
cert - carnegie mellon university's computer emergency response team
cpu - critical patch update
crud - create read update delete 
css - cascading style sheets
cvss - common vulnerability score system
D
db - data base
dbms - data base management system
dmz - demilitarized zone
dns - domain name system
dry - don't repeat yourself
dss - data security standard
E
F
ftp - file transfer protocol
G
gprs - general packet radio service
gui - graphical user interface
gsm - global system for mobile communications
H
hsm - hardware security model
html - hypertext markup language
http - hypertext transfer protocol
https - hyptertext transfer protocol over secure socket layer
I
id - identifier, identity
ide - integrated development environment
ids - intrusion detection system
ietf - internet engineering task force
imap - internat message access protocol
ip - internet protocol
ips - intrusion prevention system
ipsec - internet protocol security
iso - international standardization organisation
J
jdk - java development kit
jls - java language specification
jre - java runtime environment
jsr - java specification request
json - javascript object notation
jvm - java virtual machine
K
kic - keep it clean
kiss - keep it simple and stupid
L
lan - local area network
ldpa - lightwight directory access protocl
lpar - logical partition
loc - lines of code
M
mac - message authentication code
man - metropolitan area network
mit - massachusetts institute of technology
mo - mail order
mos - my oracle support
mpls - multi protocol label switching
mvc - model view controller
N
na - not applicable
nac - network access control
nat - network address translation
nist - national institute of standards and technology
ntp - network time protocol
nvd - national vulnerability database
O
octave - operationally critical threat asset and vulnerability evaluation
or - on request
os - operating system
owasp - open web application security project
P
pa-dss - payment application and data security standard
pan - primary account number
pat - port address translation
pci - payment card industry
pda - personal data assistant
pin - personal identification number
poi - point of interaction
pop3 - post office protocol version 3
pos - point of sale
psu - patch set update
pts - pin transaction security
pvv - pin verification value
Q
quad - quick and dirty approach
R
radius - remote authentication dial-in user service
rdbms - relational data base management system
rest - representational state transfer
roc - report on compliance
rov - report on validation
rsa - ron rivest, adi shamir, len adleman
S
s-ftp - sercure file transfer protocoll
sans - sysadmin audit networking and security
sdlc - system development life cycle
sha1 - secure hash algorithm version 1
sha2 - secure hash algorithm version 2
snmp - secure network management protocol
soa - service oriented architecture
soap - simple object access protocol
spu - security patch update
sql - structured query language
ssh - secure shell
ssl - secure sockets layer
sysadmin - system administrator
T
tcp - transmission control protocol
tdd - test driven development
tdes - triple data encryption standard
tls - transport layer security
to - telephone order
U
uml - unified modeling language
url - uniform resource locator
V
va - virtual appliance
vh - virtual hypervisor
vlan - virtual local area network
vm - virtual machine
vmm - virtual machine monitor
vpn - virtual private network
W
wan - wide area network
wep - wired equivalent privacy
wlan - wireless local area network
wpa - wifi protected access
wpa2 - wifi protected access version 2
X
xp - extreme programming
xml - extensible markup language
xss - cross site scripting
Y
Z